TILEMAP
36 28 							-- Size of tile map in tiles
16 32 							-- Tile size & block size
images/blocks.png 	-- Tilesheet
2 2 								-- Number of tiles in tilesheet
12  12  12 12 12 12 12 12 12 12 12 12 12 12 12 12 12 12 12 12 12 12 12 12 12 12 12 12 12 12 12 12 12 12 12 12 12 12 12 12 12 12 12 12 12 12 12 12 
12  12  12 12 12 12 12 12 12 12 12 12 12 12 12 12 12 12 12 12 12 12 12 12 12 12 12 12 12 12 12 12 12 12 12 12 12 12 12 12 12 12 12 12 12 12 12 12 
12  12  2  8  2  8  2  8  2  8  2  8  2  8  2  8  2  8  2  8  2  8  2  8  2  8  2  8  2  8  2  8  2  8  2  8  2  8  2  8  2  8  2  8  2  8  12 12 
12  12  8  2  8  2  8  2  8  2  8  2  8  2  8  2  8  2  8  2  8  2  8  2  8  2  8  2  8  2  8  2  8  2  8  2  8  2  8  2  8  2  8  2  8  2  12 12  
12  12  2  8  2  8  2  8  2  8  2  8  2  8  2  8  2  8  2  8  2  8  2  8  2  8  2  8  2  8  2  8  2  8  2  8  2  8  2  8  2  8  2  8  2  8  12 12  
12  12  8  2  8  2  8  2  8  2  8  2  8  2  8  2  8  2  8  2  8  2  8  2  8  2  8  2  8  2  8  2  8  2  8  2  8  2  8  2  8  2  8  2  8  2  12 12  
12  12  2  8  2  8  2  8  2  8  2  8  2  8  2  8  2  8  2  8  2  8  2  8  2  8  2  8  2  8  2  8  2  8  2  8  2  8  2  8  2  8  2  8  2  8  12 12  
12  12  8  2  8  2  8  2  8  2  8  2  8  2  8  2  8  2  8  2  8  2  8  2  8  2  8  2  8  2  8  2  8  2  8  2  8  2  8  2  8  2  8  2  8  2  12 12  
12  12  2  8  2  8  2  8  2  8  2  8  2  8  2  8  2  8  2  8  2  8  2  8  2  8  2  8  2  8  2  8  2  8  2  8  2  8  2  8  2  8  2  8  2  8  12 12  
12  12  8  2  8  2  8  2  8  2  8  2  8  2  8  2  8  2  8  2  8  2  8  2  8  2  8  2  8  2  8  2  8  2  8  2  8  2  8  2  8  2  8  2  8  2  12 12  
12  12  2  8  2  8  2  8  2  8  2  8  2  8  2  8  2  8  2  8  2  8  2  8  2  8  2  8  2  8  2  8  2  8  2  8  2  8  2  8  2  8  2  8  2  8  12 12  
12  12  8  2  8  2  8  2  8  2  8  2  8  2  8  2  8  2  8  2  8  2  8  2  8  2  8  2  8  2  8  2  8  2  8  2  8  2  8  2  8  2  8  2  8  2  12 12  
12  12  2  8  2  8  2  8  2  8  2  8  2  8  2  8  2  8  2  8  2  8  2  8  2  8  2  8  2  8  2  8  2  8  2  8  2  8  2  8  2  8  2  8  2  8  12 12  
12  12  8  2  8  2  8  2  8  2  8  2  8  2  8  2  8  2  8  2  8  2  8  2  8  2  8  2  8  2  8  2  8  2  8  2  8  2  8  2  8  2  8  2  8  2  12 12  
12  12  2  8  2  8  2  8  2  8  2  8  2  8  2  8  2  8  2  8  2  8  2  8  2  8  2  8  2  8  2  8  2  8  2  8  2  8  2  8  2  8  2  8  2  8  12 12  
12  12  8  2  8  2  8  2  8  2  8  2  8  2  8  2  8  2  8  2  8  2  8  2  8  2  8  2  8  2  8  2  8  2  8  2  8  2  8  2  8  2  8  2  8  2  12 12  
12  12  2  8  2  8  2  8  2  8  2  8  2  8  2  8  2  8  2  8  2  8  2  8  2  8  2  8  2  8  2  8  2  8  2  8  2  8  2  8  2  8  2  8  2  8  12 12  
12  12  8  2  8  2  8  2  8  2  8  2  8  2  8  2  8  2  8  2  8  2  8  2  8  2  8  2  8  2  8  2  8  2  8  2  8  2  8  2  8  2  8  2  8  2  12 12  
12  12  2  8  2  8  2  8  2  8  2  8  2  8  2  8  2  8  2  8  2  8  2  8  2  8  2  8  2  8  2  8  2  8  2  8  2  8  2  8  2  8  2  8  2  8  12 12  
12  12  8  2  8  2  8  2  8  2  8  2  8  2  8  2  8  2  8  2  8  2  8  2  8  2  8  2  8  2  8  2  8  2  8  2  8  2  8  2  8  2  8  2  8  2  12 12  
12  12  2  8  2  8  2  8  2  8  2  8  2  8  2  8  2  8  2  8  2  8  2  8  2  8  2  8  2  8  2  8  2  8  2  8  2  8  2  8  2  8  2  8  2  8  12 12  
12  12  8  2  8  2  8  2  8  2  8  2  8  2  8  2  8  2  8  2  8  2  8  2  8  2  8  2  8  2  8  2  8  2  8  2  8  2  8  2  8  2  8  2  8  2  12 12 
12  12  12 12 12 12 12 8  2  8  2  8  2  8  2  8  2  8  2  8  2  8  2  8  2  8  2  8  2  8  2  8  2  8  2  8  2  8  2  8  2  12 12 12 12 12 12 12  
12  12  12 12 12 12 12 2  8  2  8  2  8  2  8  2  8  2  8  2  8  2  8  2  8  2  8  2  8  2  8  2  8  2  8  2  8  2  8  2  8  12 12 12 12 12 12 12  
12  12  12 12 12 12 12 8  2  8  2  8  2  8  2  8  2  8  2  8  2  8  2  8  2  8  2  8  2  8  2  8  2  8  2  8  2  8  2  8  2  12 12 12 12 12 12 12  
12  12  12 12 12 12 12 2  8  2  8  2  8  2  8  2  8  2  8  2  8  2  8  2  8  2  8  2  8  2  8  2  8  2  8  2  8  2  8  2  8  12 12 12 12 12 12 12  
12  12  2  8  2  8  2  8  2  8  2  8  2  8  2  8  2  8  2  8  2  8  2  8  2  8  2  8  2  8  2  8  2  8  2  8  2  8  2  8  2  8  2  8  2  8  12 12  
12  12  8  2  8  2  8  2  8  2  8  2  8  2  8  2  8  2  8  2  8  2  8  2  8  2  8  2  8  2  8  2  8  2  8  2  8  2  8  2  8  2  8  2  8  2  12 12  
12  12  2  8  2  8  2  8  2  8  2  8  2  8  2  8  2  8  2  8  2  8  2  8  2  8  2  8  2  8  2  8  2  8  2  8  2  8  2  8  2  8  2  8  2  8  12 12  
12  12  8  2  8  2  8  2  8  2  8  2  8  2  8  2  8  2  8  2  8  2  8  2  8  2  8  2  8  2  8  2  8  2  8  2  8  2  8  2  8  2  8  2  8  2  12 12  
12  12  2  8  2  8  2  8  2  8  2  8  2  8  2  8  2  8  2  8  2  8  2  8  2  8  2  8  2  8  2  8  2  8  2  8  2  8  2  8  2  8  2  8  2  8  12 12  
12  12  8  2  8  2  8  2  8  2  8  2  8  2  8  2  8  2  8  2  8  2  8  2  8  2  8  2  8  2  8  2  8  2  8  2  8  2  8  2  8  2  8  2  8  2  12 12  
12  12  2  8  2  8  2  8  2  8  2  8  2  8  2  8  2  8  2  8  2  8  2  8  2  8  2  8  2  8  2  8  2  8  2  8  2  8  2  8  2  8  2  8  2  8  12 12  
12  12  8  2  8  2  8  2  8  2  8  2  8  2  8  2  8  2  8  2  8  2  8  2  8  2  8  2  8  2  8  2  8  2  8  2  8  2  8  2  8  2  8  2  8  2  12 12  
12  12  2  8  2  8  2  8  2  8  2  8  2  8  2  8  2  8  2  8  2  8  2  8  2  8  2  8  2  8  2  8  2  8  2  8  2  8  2  8  2  8  2  8  2  8  12 12  
12  12  8  2  8  2  8  2  8  2  8  2  8  2  8  2  8  2  8  2  8  2  8  2  8  2  8  2  8  2  8  2  8  2  8  2  8  2  8  2  8  2  8  2  8  2  12 12  
12  12  2  8  2  8  2  8  2  8  2  8  2  8  2  8  2  8  2  8  2  8  2  8  2  8  2  8  2  8  2  8  2  8  2  8  2  8  2  8  2  8  2  8  2  8  12 12  
12  12  8  2  8  2  8  2  8  2  8  2  8  2  8  2  8  2  8  2  8  2  8  2  8  2  8  2  8  2  8  2  8  2  8  2  8  2  8  2  8  2  8  2  8  2  12 12  
12  12  2  8  2  8  2  8  2  8  2  8  2  8  2  8  2  8  2  8  2  8  2  8  2  8  2  8  2  8  2  8  2  8  2  8  2  8  2  8  2  8  2  8  2  8  12 12  
12  12  8  2  8  2  8  2  8  2  8  2  8  2  8  2  8  2  8  2  8  2  8  2  8  2  8  2  8  2  8  2  8  2  8  2  8  2  8  2  8  2  8  2  8  2  12 12  
12  12  2  8  2  8  2  8  2  8  2  8  2  8  2  8  2  8  2  8  2  8  2  8  2  8  2  8  2  8  2  8  2  8  2  8  2  8  2  8  2  8  2  8  2  8  12 12  
12  12  8  2  8  2  8  2  8  2  8  2  8  2  8  2  8  2  8  2  8  2  8  2  8  2  8  2  8  2  8  2  8  2  8  2  8  2  8  2  8  2  8  2  8  2  12 12  
12  12  2  8  2  8  2  8  2  8  2  8  2  8  2  8  2  8  2  8  2  8  2  8  2  8  2  8  2  8  2  8  2  8  2  8  2  8  2  8  2  8  2  8  2  8  12 12  
12  12  8  2  8  2  8  2  8  2  8  2  8  2  8  2  8  2  8  2  8  2  8  2  8  2  8  2  8  2  8  2  8  2  8  2  8  2  8  2  8  2  8  2  8  2  12 12  
12  12  2  8  2  8  2  8  2  8  2  8  2  8  2  8  2  8  2  8  2  8  2  8  2  8  2  8  2  8  2  8  2  8  2  8  2  8  2  8  2  8  2  8  2  8  12 12  
12  12  8  2  8  2  8  2  8  2  8  2  8  2  8  2  8  2  8  2  8  2  8  2  8  2  8  2  8  2  8  2  8  2  8  2  8  2  8  2  8  2  8  2  8  2  12 12  
12  12  12 12 12 12 12 12 12 12 12 12 12 12 12 12 2  8  2  8  2  8  2  8  2  8  2  8  2  8  2  8  12 12 12 12 12 12 12 12 12 12 12 12 12 12 12 12 
12  12  12 12 12 12 12 12 12 12 12 12 12 12 12 12 8  2  8  2  8  2  8  2  8  2  8  2  8  2  8  2  12 12 12 12 12 12 12 12 12 12 12 12 12 12 12 12 
12  12  12 12 12 12 12 12 12 12 12 12 12 12 12 12 12 12 12 12 12 12 12 12 12 12 12 12 12 12 12 12 12 12 12 12 12 12 12 12 12 12 12 12 12 12 12 12 
12  12  12 12 12 12 12 12 12 12 12 12 12 12 12 12 12 12 12 12 12 12 12 12 12 12 12 12 12 12 12 12 12 12 12 12 12 12 12 12 12 12 12 12 12 12 12 12 
12  12  2  8  2  8  2  8  2  8  2  8  2  8  2  8  2  8  2  8  2  8  2  8  2  8  2  8  2  8  2  8  2  8  2  8  2  8  2  8  2  8  2  8  2  8  12 12 
12  12  8  2  8  2  8  2  8  2  8  2  8  2  8  2  8  2  8  2  8  2  8  2  8  2  8  2  8  2  8  2  8  2  8  2  8  2  8  2  8  2  8  2  8  2  12 12  
12  12  2  8  2  8  2  8  2  8  2  8  2  8  2  8  2  8  2  8  2  8  2  8  2  8  2  8  2  8  2  8  2  8  2  8  2  8  2  8  2  8  2  8  2  8  12 12  
12  12  8  2  8  2  8  2  8  2  8  2  8  2  8  2  8  2  8  2  8  2  8  2  8  2  8  2  8  2  8  2  8  2  8  2  8  2  8  2  8  2  8  2  8  2  12 12  
12  12  2  8  2  8  2  8  2  8  2  8  2  8  2  8  2  8  2  8  2  8  2  8  2  8  2  8  2  8  2  8  2  8  2  8  2  8  2  8  2  8  2  8  2  8  12 12  
12  12  8  2  8  2  8  2  8  2  8  2  8  2  8  2  8  2  8  2  8  2  8  2  8  2  8  2  8  2  8  2  8  2  8  2  8  2  8  2  8  2  8  2  8  2  12 12  
12  12  2  8  2  8  2  8  2  8  2  8  2  8  2  8  2  8  2  8  2  8  2  8  2  8  2  8  2  8  2  8  2  8  2  8  2  8  2  8  2  8  2  8  2  8  12 12  
12  12  8  2  8  2  8  2  8  2  8  2  8  2  8  2  8  2  8  2  8  2  8  2  8  2  8  2  8  2  8  2  8  2  8  2  8  2  8  2  8  2  8  2  8  2  12 12  
12  12  2  8  2  8  2  8  2  8  2  8  2  8  2  8  2  8  2  8  2  8  2  8  2  8  2  8  2  8  2  8  2  8  2  8  2  8  2  8  2  8  2  8  2  8  12 12  
12  12  8  2  8  2  8  2  8  2  8  2  8  2  8  2  8  2  8  2  8  2  8  2  8  2  8  2  8  2  8  2  8  2  8  2  8  2  8  2  8  2  8  2  8  2  12 12  
12  12  2  8  2  8  2  8  2  8  2  8  2  8  2  8  2  8  2  8  2  8  2  8  2  8  2  8  2  8  2  8  2  8  2  8  2  8  2  8  2  8  2  8  2  8  12 12  
12  12  8  2  8  2  8  2  8  2  8  2  8  2  8  2  8  2  8  2  8  2  8  2  8  2  8  2  8  2  8  2  8  2  8  2  8  2  8  2  8  2  8  2  8  2  12 12  
12  12  2  8  2  8  2  8  2  8  2  8  2  8  2  8  2  8  2  8  2  8  2  8  2  8  2  8  2  8  2  8  2  8  2  8  2  8  2  8  2  8  2  8  2  8  12 12  
12  12  8  2  8  2  8  2  8  2  8  2  8  2  8  2  8  2  8  2  8  2  8  2  8  2  8  2  8  2  8  2  8  2  8  2  8  2  8  2  8  2  8  2  8  2  12 12  
12  12  2  8  2  8  2  8  2  8  2  8  2  8  2  8  2  8  2  8  2  8  2  8  2  8  2  8  2  8  2  8  2  8  2  8  2  8  2  8  2  8  2  8  2  8  12 12  
12  12  8  2  8  2  8  2  8  2  8  2  8  2  8  2  8  2  8  2  8  2  8  2  8  2  8  2  8  2  8  2  8  2  8  2  8  2  8  2  8  2  8  2  8  2  12 12  
12  12  2  8  2  8  2  8  2  8  2  8  2  8  2  8  2  8  2  8  2  8  2  8  2  8  2  8  2  8  2  8  2  8  2  8  2  8  2  8  2  8  2  8  2  8  12 12  
12  12  8  2  8  2  8  2  8  2  8  2  8  2  8  2  8  2  8  2  8  2  8  2  8  2  8  2  8  2  8  2  8  2  8  2  8  2  8  2  8  2  8  2  8  2  12 12  
12  12  2  8  2  8  2  8  2  8  2  8  2  8  2  8  2  8  2  8  2  8  2  8  2  8  2  8  2  8  2  8  2  8  2  8  2  8  2  8  2  8  2  8  2  8  12 12  
12  12  8  2  8  2  8  2  8  2  8  2  8  2  8  2  8  2  8  2  8  2  8  2  8  2  8  2  8  2  8  2  8  2  8  2  8  2  8  2  8  2  8  2  8  2  12 12  
12  12  2  8  2  8  2  8  2  8  2  8  2  8  2  8  2  8  2  8  2  8  2  8  2  8  2  8  2  8  2  8  2  8  2  8  2  8  2  8  2  8  2  8  2  8  12 12  
12  12  8  2  8  2  8  2  8  2  8  2  8  2  8  2  8  2  8  12 12 12 12 12 12 12 12 12 8  2  8  2  8  2  8  2  8  2  8  2  8  2  8  2  8  2  12 12  
12  12  2  8  2  8  2  8  2  8  2  8  2  8  2  8  2  8  2  12 12 12 12 12 12 12 12 12 2  8  2  8  2  8  2  8  2  8  2  8  2  8  2  8  2  8  12 12  
12  12  8  2  8  2  8  2  8  2  8  2  8  2  8  2  8  2  8  2  8  2  8  2  8  2  8  2  8  2  8  2  8  2  8  2  8  2  8  2  8  2  8  2  8  2  12 12  
12  12  2  8  2  8  2  8  2  8  2  8  2  8  2  8  2  8  2  8  2  8  2  8  2  8  2  8  2  8  2  8  2  8  2  8  2  8  2  8  2  8  2  8  2  8  12 12  
12  12  8  2  8  2  8  2  8  2  8  2  8  2  8  2  8  2  8  2  8  2  8  2  8  2  8  2  8  2  8  2  8  2  8  2  8  2  8  2  8  2  8  2  8  2  12 12  
12  12  2  8  2  8  2  8  2  8  2  8  2  8  2  8  2  8  2  8  2  8  2  8  2  8  2  8  2  8  2  8  2  8  2  8  2  8  2  8  2  8  2  8  2  8  12 12  
12  12  8  2  8  2  8  2  8  2  8  2  8  2  8  2  8  2  8  2  8  2  8  2  8  2  8  2  8  2  8  2  8  2  8  2  8  2  8  2  8  2  8  2  8  2  12 12  
12  12  2  8  2  8  2  8  2  8  2  8  2  8  2  8  2  8  2  8  2  8  2  8  2  8  2  8  2  8  2  8  2  8  2  8  2  8  2  8  2  8  2  8  2  8  12 12  
12  12  8  2  8  2  8  2  8  2  8  2  8  2  8  2  8  2  8  2  8  2  8  2  8  2  8  2  8  2  8  2  8  2  8  2  8  2  8  2  8  2  8  2  8  2  12 12  
12  12  2  8  2  8  2  8  2  8  2  8  2  8  2  8  2  8  2  8  2  8  2  8  2  8  2  8  2  8  2  8  2  8  2  8  2  8  2  8  2  8  2  8  2  8  12 12  
12  12  8  2  8  2  8  2  8  2  8  2  8  2  8  2  8  2  8  2  8  2  8  2  8  2  8  2  8  2  8  2  8  2  8  2  8  2  8  2  8  2  8  2  8  2  12 12  
12  12  2  8  2  8  2  8  2  8  2  8  2  8  2  8  2  8  2  8  2  8  2  8  2  8  2  8  2  8  2  8  2  8  2  8  2  8  2  8  2  8  2  8  2  8  12 12  
12  12  8  2  8  2  8  2  8  2  8  2  8  2  8  2  8  2  8  2  8  2  8  2  8  2  8  2  8  2  8  2  8  2  8  2  8  2  8  2  8  2  8  2  8  2  12 12  
12  12  2  8  2  8  2  8  2  8  2  8  2  8  2  8  2  8  2  8  2  8  2  8  2  8  2  8  2  8  2  8  2  8  2  8  2  8  2  8  2  8  2  8  2  8  12 12  
12  12  8  2  8  2  8  2  8  2  8  2  8  2  8  2  8  2  8  2  8  2  8  2  8  2  8  2  8  2  8  2  8  2  8  2  8  2  8  2  8  2  8  2  8  2  12 12  
12  12  2  8  2  8  2  8  2  8  2  8  2  8  2  8  2  8  2  8  2  8  2  8  2  8  2  8  2  8  2  8  2  8  2  8  2  8  2  8  2  8  2  8  2  8  12 12  
12  12  8  2  8  2  8  2  8  2  8  2  8  2  8  2  8  2  8  2  8  2  8  2  8  2  8  2  8  2  8  2  8  2  8  2  8  2  8  2  8  2  8  2  8  2  12 12  
12  12  2  8  2  8  2  8  2  8  2  8  2  8  2  8  2  8  2  8  2  8  2  8  2  8  2  8  2  8  2  8  2  8  2  8  2  8  2  8  2  8  2  8  2  8  12 12  
12  12  8  2  8  2  8  2  8  2  8  2  8  2  8  2  8  2  8  2  8  2  8  2  8  2  8  2  8  2  8  2  8  2  8  2  8  2  8  2  8  2  8  2  8  2  12 12  
12  12  2  8  2  8  2  8  2  8  2  8  2  8  2  8  2  8  2  8  2  8  2  8  2  8  2  8  2  8  2  8  2  8  2  8  2  8  2  8  2  8  2  8  2  8  12 12  
12  12  8  2  8  2  8  2  8  2  8  2  8  2  8  2  8  2  8  2  8  2  8  2  8  2  8  2  8  2  8  2  8  2  8  2  8  2  8  2  8  2  8  2  8  2  12 12  
12  12  2  8  2  8  2  8  2  8  2  8  2  8  2  8  2  8  2  8  2  8  2  8  2  8  2  8  2  8  2  8  2  8  2  8  2  8  2  8  2  8  2  8  2  8  12 12  
12  12  8  2  8  2  8  2  8  2  8  2  8  2  8  2  8  2  8  2  8  2  8  2  8  2  8  2  8  2  8  2  8  2  8  2  8  2  8  2  8  2  8  2  8  2  12 12  
12  12  12 12 12 12 12 12 12 12 12 12 12 12 12 12 2  8  2  8  2  8  2  8  2  8  2  8  2  8  2  8  12 12 12 12 12 12 12 12 12 12 12 12 12 12 12 12  
12  12  12 12 12 12 12 12 12 12 12 12 12 12 12 12 8  2  8  2  8  2  8  2  8  2  8  2  8  2  8  2  12 12 12 12 12 12 12 12 12 12 12 12 12 12 12 12  
12  12  12 12 12 12 12 12 12 12 12 12 12 12 12 12 12 12 12 12 12 12 12 12 12 12 12 12 12 12 12 12 12 12 12 12 12 12 12 12 12 12 12 12 12 12 12 12  
12  12  12 12 12 12 12 12 12 12 12 12 12 12 12 12 12 12 12 12 12 12 12 12 12 12 12 12 12 12 12 12 12 12 12 12 12 12 12 12 12 12 12 12 12 12 12 12 
12  12  2  8  2  8  2  8  2  8  2  8  2  8  2  8  2  8  2  8  2  8  2  8  2  8  2  8  2  8  2  8  2  8  2  8  2  8  2  8  2  8  2  8  2  8  12 12  
12  12  8  2  8  2  8  2  8  2  8  2  8  2  8  2  8  2  8  2  8  2  8  2  8  2  8  2  8  2  8  2  8  2  8  2  8  2  8  2  8  2  8  2  8  2  12 12  
12  12  2  8  2  8  2  8  2  8  2  8  2  8  2  8  2  8  2  8  2  8  2  8  2  8  2  8  2  8  2  8  2  8  2  8  2  8  2  8  2  8  2  8  2  8  12 12  
12  12  8  2  8  2  8  2  8  2  8  2  8  2  8  2  8  2  8  2  8  2  8  2  8  2  8  2  8  2  8  2  8  2  8  2  8  2  8  2  8  2  8  2  8  2  12 12  
12  12  2  8  2  8  2  8  2  8  2  8  2  8  2  8  2  8  2  8  2  8  2  8  2  8  2  8  2  8  2  8  2  8  2  8  2  8  2  8  2  8  2  8  2  8  12 12  
12  12  8  2  8  2  8  2  8  2  8  2  8  2  8  2  8  2  8  2  8  2  8  2  8  2  8  2  8  2  8  2  8  2  8  2  8  2  8  2  8  2  8  2  8  2  12 12  
12  12  2  8  2  8  2  8  2  8  2  8  2  8  2  8  2  8  2  8  2  8  2  8  2  8  2  8  2  8  2  8  2  8  2  8  2  8  2  8  2  8  2  8  2  8  12 12  
12  12  8  2  8  2  8  2  8  2  8  2  8  2  8  2  8  2  8  2  8  2  8  2  8  2  8  2  8  2  8  2  8  2  8  2  8  2  8  2  8  2  8  2  8  2  12 12  
12  12  2  8  2  8  2  8  2  8  2  8  2  8  2  8  2  8  2  8  2  8  2  8  2  8  2  8  2  8  2  8  2  8  2  8  2  8  2  8  2  8  2  8  2  8  12 12  
12  12  8  2  8  2  8  2  8  2  8  2  8  2  8  2  8  2  8  2  8  2  8  2  8  2  8  2  8  2  8  2  8  2  8  2  8  2  8  2  8  2  8  2  8  2  12 12  
12  12  2  8  2  8  2  8  2  8  2  8  2  8  2  8  2  8  2  8  2  8  2  8  2  8  2  8  2  8  2  8  2  8  2  8  2  8  2  8  2  8  2  8  2  8  12 12  
12  12  8  2  8  2  8  2  8  2  8  2  8  2  8  2  8  2  8  2  8  2  8  2  8  2  8  2  8  2  8  2  8  2  8  2  8  2  8  2  8  2  8  2  8  2  12 12  
12  12  2  8  2  8  2  8  2  8  2  8  2  8  2  8  2  8  2  8  2  8  2  8  2  8  2  8  2  8  2  8  2  8  2  8  2  8  2  8  2  8  2  8  2  8  12 12  
12  12  8  2  8  2  8  2  8  2  8  2  8  2  8  2  8  2  8  2  8  2  8  2  8  2  8  2  8  2  8  2  8  2  8  2  8  2  8  2  8  2  8  2  8  2  12 12  
12  12  2  8  2  8  2  8  2  8  2  8  2  8  2  8  2  8  2  8  2  8  2  8  2  8  2  8  2  8  2  8  2  8  2  8  2  8  2  8  2  8  2  8  2  8  12 12  
12  12  8  2  8  2  8  2  8  2  8  2  8  2  8  2  8  2  8  2  8  2  8  2  8  2  8  2  8  2  8  2  8  2  8  2  8  2  8  2  8  2  8  2  8  2  12 12  
12  12  2  8  2  8  2  8  2  8  2  8  2  8  2  8  2  8  2  8  2  8  2  8  2  8  2  8  2  8  2  8  2  8  2  8  2  8  2  8  2  8  2  8  2  8  12 12  
12  12  8  2  8  2  8  2  8  2  8  2  8  2  8  2  8  2  8  2  8  2  8  2  8  2  8  2  8  2  8  2  8  2  8  2  8  2  8  2  8  2  8  2  8  2  12 12  
12  12  2  8  2  8  2  8  2  8  2  8  2  8  2  8  2  8  2  8  2  8  2  8  2  8  2  8  2  8  2  8  2  8  2  8  2  8  2  8  2  8  2  8  2  8  12 12  
12  12  8  2  8  2  8  2  8  2  8  2  8  2  8  2  8  2  8  2  8  2  8  2  8  2  8  2  8  2  8  2  8  2  8  2  8  2  8  2  8  2  8  2  8  2  12 12  
12  12  2  8  2  8  2  8  2  8  2  8  2  8  2  8  2  8  2  8  2  8  2  8  2  8  2  8  2  8  2  8  2  8  2  8  2  8  2  8  2  8  2  8  2  8  12 12  
12  12  8  2  8  2  8  2  8  2  8  2  8  2  8  2  8  2  8  2  8  2  8  2  8  2  8  2  8  2  8  2  8  2  8  2  8  2  8  2  8  2  8  2  8  2  12 12  
12  12  2  8  2  8  2  8  2  8  2  8  2  8  2  8  2  8  2  8  2  8  2  8  2  8  2  8  2  8  2  8  2  8  2  8  2  8  2  8  2  8  2  8  2  8  12 12  
12  12  8  2  8  2  8  2  8  2  8  2  8  2  8  2  8  2  8  2  8  2  8  2  8  2  8  2  8  2  8  2  8  2  8  2  8  2  8  2  8  2  8  2  8  2  12 12  
12  12  2  8  2  8  2  8  2  8  2  8  2  8  2  8  2  8  2  8  2  8  2  8  2  8  2  8  2  8  2  8  2  8  2  8  2  8  2  8  2  8  2  8  2  8  12 12  
12  12  8  2  8  2  8  2  8  2  8  2  8  2  8  2  8  2  8  2  8  2  8  2  8  2  8  2  8  2  8  2  8  2  8  2  8  2  8  2  8  2  8  2  8  2  12 12  
12  12  2  8  2  8  2  8  2  8  2  8  2  8  2  8  2  8  2  8  2  8  2  8  2  8  2  8  2  8  2  8  2  8  2  8  2  8  2  8  2  8  2  8  2  8  12 12  
12  12  8  2  8  2  8  2  8  2  8  2  8  2  8  2  8  2  8  2  8  2  8  2  8  2  8  2  8  2  8  2  8  2  8  2  8  2  8  2  8  2  8  2  8  2  12 12  
12  12  2  8  2  8  2  8  2  8  2  8  2  8  2  8  2  8  2  8  2  8  2  8  2  8  2  8  2  8  2  8  2  8  2  8  2  8  2  8  2  8  2  8  2  8  12 12  
12  12  8  2  8  2  8  2  8  2  8  2  8  2  8  2  8  2  8  2  8  2  8  2  8  2  8  2  8  2  8  2  8  2  8  2  8  2  8  2  8  2  8  2  8  2  12 12  
12  12  2  8  2  8  2  8  2  8  2  8  2  8  2  8  2  8  2  8  2  8  2  8  2  8  2  8  2  8  2  8  2  8  2  8  2  8  2  8  2  8  2  8  2  8  12 12  
12  12  8  2  8  2  8  2  8  2  8  2  8  2  8  2  8  2  8  2  8  2  8  2  8  2  8  2  8  2  8  2  8  2  8  2  8  2  8  2  8  2  8  2  8  2  12 12  
12  12  2  8  2  8  2  8  2  8  2  8  2  8  2  8  2  8  2  8  2  8  2  8  2  8  2  8  2  8  2  8  2  8  2  8  2  8  2  8  2  8  2  8  2  8  12 12  
12  12  8  2  8  2  8  2  8  2  8  2  8  2  8  2  8  2  8  2  8  2  8  2  8  2  8  2  8  2  8  2  8  2  8  2  8  2  8  2  8  2  8  2  8  2  12 12  
12  12  2  8  2  8  2  8  2  8  2  8  2  8  2  8  2  8  2  8  2  8  2  8  2  8  2  8  2  8  2  8  2  8  2  8  2  8  2  8  2  8  2  8  2  8  12 12  
12  12  8  2  8  2  8  2  8  2  8  2  8  2  8  2  8  2  8  2  8  2  8  2  8  2  8  2  8  2  8  2  8  2  8  2  8  2  8  2  8  2  8  2  8  2  12 12  
12  12  2  8  2  8  2  8  2  8  2  8  2  8  2  8  2  8  2  8  2  8  2  8  2  8  2  8  2  8  2  8  2  8  2  8  2  8  2  8  2  8  2  8  2  8  12 12  
12  12  8  2  8  2  8  2  8  2  8  2  8  2  8  2  8  2  8  2  8  2  8  2  8  2  8  2  8  2  8  2  8  2  8  2  8  2  8  2  8  2  8  2  8  2  12 12  
12  12  2  8  2  8  2  8  2  8  2  8  2  8  2  8  2  8  2  8  2  8  2  8  2  8  2  8  2  8  2  8  2  8  2  8  2  8  2  8  2  8  2  8  2  8  12 12  
12  12  8  2  8  2  8  2  8  2  8  2  8  2  8  2  8  2  8  2  8  2  8  2  8  2  8  2  8  2  8  2  8  2  8  2  8  2  8  2  8  2  8  2  8  2  12 12  
12  12  2  8  2  8  2  8  2  8  2  8  2  8  2  8  2  8  2  8  2  8  2  8  2  8  2  8  2  8  2  8  2  8  2  8  2  8  2  8  2  8  2  8  2  8  12 12  
12  12  8  2  8  2  8  2  8  2  8  2  8  2  8  2  8  2  8  2  8  2  8  2  8  2  8  2  8  2  8  2  8  2  8  2  8  2  8  2  8  2  8  2  8  2  12 12  
12  12  2  8  2  8  2  8  2  8  2  8  2  8  2  8  2  8  2  8  2  8  2  8  2  8  2  8  2  8  2  8  2  8  2  8  2  8  2  8  2  8  2  8  2  8  12 12  
12  12  8  2  8  2  8  2  8  2  8  2  8  2  8  2  8  2  8  2  8  2  8  2  8  2  8  2  8  2  8  2  8  2  8  2  8  2  8  2  8  2  8  2  8  2  12 12  
12  12  12 12 12 12 12 12 12 12 12 12 12 12 12 12 2  8  2  8  2  8  2  8  2  8  2  8  2  8  2  8  12 12 12 12 12 12 12 12 12 12 12 12 12 12 12 12  
12  12  12 12 12 12 12 12 12 12 12 12 12 12 12 12 8  2  8  2  8  2  8  2  8  2  8  2  8  2  8  2  12 12 12 12 12 12 12 12 12 12 12 12 12 12 12 12
