TILEMAP
24 84 							-- Size of tile map in tiles
16 16 							  -- Tile size & block size
images/fons_futurista.png   	-- Tilesheet
4 3 								-- Number of tiles in tilesheet
2 2 2 2 2 2 2 2 2 2 2 2 2 2 2 2 2 2 2 2 2 2 2 2
2 5 6 7 5 6 7 7 5 6 10 5 6 7 5 6 5 6 10 7 7 5 6 2
2 8 9 10 8 9 10 10 8 9 8 10 7 9 8 9 8 7 8 10 10 8 9 2
2 7 8 5 6 10 8 5 6 7 7 8 6 10 7 6 10 5 6 5 6 7 8 2
2 10 9 8 9 8 10 8 9 10 10 10 9 8 8 9 8 8 9 10 7 10 7 2
2 5 5 6 5 6 7 5 5 5 6 7 5 6 5 8 10 7 7 5 6 9 8 2
2 7 8 8 8 9 10 8 7 8 8 10 8 7 8 7 8 10 10 8 9 5 6 2
2 5 6 7 5 6 7 7 5 6 10 5 6 7 5 6 5 6 10 7 7 5 6 2
2 10 9 8 9 8 10 8 9 10 10 10 9 8 8 9 8 8 9 10 7 10 7 2
2 5 6 7 5 6 2 2 2 2 2 2 2 2 2 2 2 2 10 7 7 5 6 2
2 8 9 10 8 9 2 10 8 9 8 10 7 9 8 9 8 2 8 10 10 8 9 2
2 7 8 5 6 10 2 5 6 7 7 8 6 10 7 6 10 2 6 5 6 7 8 2
2 10 9 8 9 8 2 8 9 10 10 10 9 8 8 9 8 2 9 10 7 10 7 2
2 5 5 6 5 6 2 5 5 5 6 7 5 6 5 8 10 2 7 5 6 9 8 2
2 7 8 8 8 9 2 8 7 8 8 10 8 7 8 7 8 2 10 8 9 5 6 2
2 5 6 7 5 6 2 7 5 6 10 5 6 7 5 6 5 2 10 7 7 5 6 2
2 8 9 10 8 9 2 10 8 9 8 10 7 9 8 9 8 2 8 10 10 8 9 2
2 7 8 5 6 10 2 5 6 7 7 8 6 10 7 6 10 2 6 5 6 7 8 2
2 10 9 8 9 8 10 8 9 10 10 10 9 8 8 9 8 8 9 10 7 10 7 2
2 5 5 6 5 6 7 5 5 5 6 7 5 6 5 8 10 7 7 5 6 9 8 2
2 7 8 8 8 9 10 8 7 2 2 2 2 2 2 7 8 10 10 8 9 5 6 2
2 7 8 5 6 10 8 5 6 7 7 8 6 10 7 6 10 5 6 5 6 7 8 2
2 5 6 7 5 6 7 7 5 6 10 5 6 7 5 6 5 6 10 7 7 5 6 2
2 8 9 10 8 9 10 10 8 9 8 10 7 9 8 9 8 7 8 10 10 8 9 2
2 7 8 5 6 10 8 5 6 7 7 8 6 10 7 6 10 5 6 5 6 7 8 2
2 10 9 8 9 8 10 8 9 10 10 10 9 8 8 9 8 8 9 10 7 10 7 2
2 7 8 5 6 10 8 5 6 7 7 8 6 10 7 6 10 5 6 5 6 7 8 2
2 2 2 2 2 2 9 5 6 10 8 10 7 10 7 8 9 7 2 2 2 2 2 2
2 2 2 2 2 2 2 2 2 2  10 9 6 7  2 2 2 2 2 2 2 2 2 2
2 5 6 7 5 6 7 7 5 6 10 5 6 7 5 6 5 6 10 7 7 5 6 2
2 8 9 10 8 9 10 10 8 9 8 10 7 9 8 9 8 7 8 10 10 8 9 2
2 7 8 5 6 10 8 5 6 7 7 8 6 10 7 6 10 5 6 5 6 7 8 2
2 10 9 8 9 8 10 8 9 10 10 10 9 8 8 9 8 8 9 10 7 10 7 2
2 2 2 2 2 6 7 5 5 5 6 7 5 6 5 8 10 7 7 2 2 2 2 2
2 7 8 8 2 9 10 8 7 8 8 10 8 7 8 7 8 10 10 2 9 5 6 2
2 5 6 7 2 6 7 7 5 6 10 5 6 7 5 6 5 6 10 2 7 5 6 2
2 5 5 6 2 6 7 5 5 5 6 7 5 6 5 8 10 7 7 2 6 9 8 2
2 8 9 10 8 9 10 10 8 9 8 10 7 9 8 9 8 7 8 10 10 8 9 2
2 7 8 5 6 10 8 5 6 7 7 8 6 10 7 6 10 5 6 5 6 7 8 2
2 10 9 8 9 8 10 8 9 10 10 10 9 8 8 9 8 8 9 10 7 10 7 2
2 5 6 7 2 6 7 7 5 6 10 5 6 7 5 6 5 6 10 2 7 5 6 2
2 5 5 6 2 6 7 5 5 5 6 7 5 6 5 8 10 7 7 2 6 9 8 2
2 7 8 8 2 9 10 8 7 8 8 10 8 7 8 7 8 10 10 2 9 5 6 2
2 2 2 2 2 6 7 7 5 6 10 5 6 7 5 6 5 6 10 2 2 2 2 2
2 8 9 10 8 9 10 10 8 9 8 10 7 9 8 9 8 7 8 10 10 8 9 2
2 7 8 5 6 10 8 5 6 7 7 8 6 10 7 6 10 5 6 5 6 7 8 2
2 7 8 5 6 10 8 5 6 7 7 8 6 10 7 6 10 5 6 5 6 7 8 2
2 8 9 10 8 9 10 10 8 9 8 10 7 9 8 9 8 7 8 10 10 8 9 2
2 10 9 8 9 8 10 8 9 2 2 2 2 2 2 9 8 8 9 10 7 10 7 2
2 5 5 6 5 6 7 5 5 5 6 7 5 6 5 8 10 7 7 5 6 9 8 2
2 7 8 8 8 9 10 8 7 8 8 10 8 7 8 7 8 10 10 8 9 5 6 2
2 5 6 7 5 6 7 7 5 6 10 5 6 7 5 6 5 6 10 7 7 5 6 2
2 8 9 10 8 9 10 10 8 9 8 10 7 9 8 9 8 7 8 10 10 8 9 2
2 7 8 5 6 10 8 5 6 7 7 8 6 10 7 6 10 5 6 5 6 7 8 2
2 10 9 8 9 8 10 8 9 10 10 10 9 8 8 9 8 8 9 10 7 10 7 2
2 2 2 2 2 2 10 7 9 8 10 9 8 10 9 8 10 9 2 2 2 2 2 2
2 2 2 2 2 2 2  2 2 2 10 9 8 10 2 2 2  2 2 2 2 2 2 2
2 5 6 7 5 6 7 7 5 6 10 5 6 7 5 6 5 6 10 7 7 5 6 2
2 5 5 6 5 6 7 5 5 5 6 7 5 6 5 8 10 7 7 8 9 5 7 2
2 8 9 10 8 9 10 10 8 9 8 10 7 9 8 9 8 7 8 10 10 8 9 2
2 7 8 5 6 10 8 5 6 7 7 8 6 10 7 6 10 5 6 5 6 7 8 2
2 10 9 8 9 8 10 8 9 10 10 10 9 8 8 9 8 8 9 10 7 10 7 2
2 5 5 6 5 6 7 5 5 5 6 7 5 6 5 8 10 7 7 5 6 9 8 2
2 7 8 8 8 9 10 8 7 8 8 10 8 7 8 7 8 10 10 8 9 5 6 2
2 9 7 10 5 6 7 7 5 6 10 5 6 7 5 6 5 6 10 7 8 10 7 2
2 8 9 10 8 9 10 10 8 9 8 10 7 9 8 9 8 7 8 10 10 8 9 2
2 2 2 10 8 9 10 10 8 9 8 10 7 9 8 9 8 7 8 10 8 2 2 2
2 2 2 5 6 10 8 5 6 7 7 8 6 10 7 6 10 5 6 5 6 2 2 2
2 2 2 8 9 8 10 8 9 10 10 10 9 8 8 9 8 8 9 8 9 2 2 2
2 2 2 5 5 6 7 5 5 5 6 7 5 6 5 8 10 7 7 5 5 2 2 2
2 2 2 8 7 9 10 8 7 8 8 10 8 7 8 7 8 10 10 8 7 2 2 2
2 2 2 7 5 6 7 7 5 6 10 5 6 7 5 6 5 6 10 7 5 2 2 2
2 2 2 10 8 9 10 10 8 9 8 10 7 9 8 9 8 7 8 10 8 2 2 2
2 2 2 5 6 10 8 5 6 7 7 8 6 10 7 6 10 5 6 5 6 2 2 2
2 8 9 8 9 8 10 8 9 10 10 10 9 8 8 9 8 8 9 6 8 10 9 2
2 7 8 8 8 9 10 8 7 8 8 10 8 7 8 7 8 10 10 8 9 5 6 2
2 5 5 6 5 6 7 5 5 5 6 7 5 6 5 8 10 7 7 8 9 5 7 2
2 7 8 8 8 9 10 8 7 8 8 10 8 7 8 7 8 10 10 8 9 8 9 2
2 5 6 7 5 6 7 7 5 6 10 5 6 7 5 6 5 6 10 7 7 5 6 2
2 8 9 10 8 9 10 10 8 9 8 10 7 9 8 9 8 7 8 10 10 8 9 2
2 7 8 5 6 10 8 5 6 7 7 8 6 10 7 6 10 5 6 5 6 7 8 2
2 7 8 8 8 9 10 8 7 8 8 10 8 7 8 7 8 10 10 8 9 5 6 2
2 10 9 8 9 8 10 8 9 10 10 10 9 9 8 9 8 8 9 10 7 10 7 2
2 2 2 2 2 2 10 8 10 7 9 5 7 9 5 6 9 7 2 2 2 2 2 2
