TILEMAP
24 72 							-- Size of tile map in tiles
16 16							  -- Tile size & block size
images/fons_futurista.png   	-- Tilesheet
4 3 								-- Number of tiles in tilesheet
3 3 3 3 3 3 3 3 3 3 3 3 3 3 3 3 3 3 3 3 3 3 3 3
3 11 12 11 12 11 12 11 12 11 12 11 12 11 12 11 12 11 12 11 12 11 12 3
3 11 12 11 12 11 12 11 12 11 12 11 12 11 12 11 12 11 12 11 12 11 12 3
3 11 12 11 12 11 12 11 12 11 12 11 12 11 12 11 12 11 12 11 12 11 12 3
3 11 12 11 12 11 12 11 12 11 12 11 12 11 12 11 12 11 12 11 12 11 12 3
3 11 12 11 12 11 12 11 12 11 12 11 12 11 12 11 12 11 12 11 12 11 12 3
3 11 12 11 12 11 12 11 12 11 12 11 12 11 12 11 12 11 12 11 12 11 12 3
3 3  3  3  3  11 12 11 12 11 12 11 12 11 12 11 12 11 12 3  3  3  3  3
3 11 12 11 12 11 12 11 12 11 12 11 12 11 12 11 12 11 12 11 12 11 12 3
3 11 12 11 12 11 12 11 12 3  3  3  3  3  3  11 12 11 12 11 12 11 12 3
3 11 12 11 12 11 12 11 12 3  12 11 12 11 3  11 12 11 12 11 12 11 12 3
3 11 12 11 12 11 12 3  3  3  12 11 12 11 3  3  3  11 12 11 12 11 12 3
3 11 12 11 12 11 12 3  12 11 12 11 12 11 12 11 3  11 12 11 12 11 12 3
3 11 12 11 12 11 12 3  12 11 12 11 12 11 12 11 3  11 12 11 12 11 12 3
3 11 12 11 12 11 12 11 12 11 12 11 12 11 12 11 12 11 12 11 12 11 12 3
3 11 12 11 12 11 12 11 12 11 12 11 12 11 12 11 12 11 12 11 12 11 12 3
3 11 12 11 12 11 12 11 12 11 12 11 12 11 12 11 12 11 12 11 12 11 12 3
3 11 12 11 12 11 12 11 12 11 12 11 12 11 12 11 12 11 12 11 12 11 12 3
3 11 12 11 12 11 12 11 12 11 12 11 12 11 12 11 12 11 12 11 12 11 12 3
3 3  3  3  3  11 12 11 12 11 12 11 12 11 12 11 12 11 12 3  3  3  3  3
3 11 12 11 12 3  3  3  3  11 12 11 12 11 12 3  3  3  3  11 12 11 12 3
3 11 12 11 12 11 12 11 12 11 12 11 12 11 12 11 12 11 12 11 12 11 12 3
3 11 12 11 12 11 12 11 12 11 12 11 12 11 12 11 12 11 12 11 12 11 12 3
3 11 12 11 12 11 12 11 12 11 12 11 12 11 12 11 12 11 12 11 12 11 12 3
3 11 12 11 12 11 12 11 12 11 12 11 12 11 12 11 12 11 12 11 12 11 12 3
3 11 12 11 12 11 12 11 12 11 12 11 12 11 12 11 12 11 12 11 12 11 12 3
3 11 12 11 12 11 12 11 12 11 12 11 12 11 12 11 12 11 12 11 12 11 12 3
3 3 3 3 3 11 12 11 12 11 12 11 12 11 12 11 12 11 12 3 3 3 3 3
3 3 3 3 3 11 12 11 12 11 12 11 12 11 12 11 12 11 12 3 3 3 3 3
3 3 3 3 3 11 12 11 12 11 12 11 12 11 12 11 12 11 12 3 3 3 3 3
3 11 12 11 12 11 12 11 12 11 12 11 12 11 12 11 12 11 12 11 12 11 12 3
3 11 12 11 12 11 12 11 12 11 12 11 12 11 12 11 12 11 12 11 12 11 12 3
3 11 12 11 12 11 12 11 12 11 12 11 12 11 12 11 12 11 12 11 12 11 12 3
3 11 12 11 12 11 12 11 12 11 12 11 12 11 12 11 12 11 12 11 12 11 12 3
3 11 12 11 12 11 12 11 12 11 12 11 12 11 12 11 12 11 12 11 12 11 12 3
3 11 12 11 12 11 12 11 12 11 12 11 12 11 12 11 12 11 12 11 12 11 12 3
3 11 12 11 12 11 12 11 12 11 12 11 12 11 12 11 12 11 12 11 12 11 12 3
3 11 12 11 12 11 3  11 12 11 12 11 12 11 12 11 12 3  12 11 12 11 12 3
3 11 12 11 12 11 12 3  12 11 12 11 12 11 12 11 3  11 12 11 12 11 12 3
3 11 12 11 12 11 12 11 3  11 12 11 12 11 12 3  12 11 12 11 12 11 12 3
3 11 12 11 12 11 12 11 12 3  12 11 12 11 3  11 12 11 12 11 12 11 12 3
3 11 12 11 12 11 12 11 12 11 3  11 12 3  12 11 12 11 12 11 12 11 12 3
3 11 12 11 12 11 12 11 12 11 12 3  3  11 12 11 12 11 12 11 12 11 12 3
3 11 12 11 12 11 12 11 12 11 12 3  3  11 12 11 12 11 12 11 12 11 12 3
3 11 12 11 12 11 12 11 12 11 3  11 12 3  12 11 12 11 12 11 12 11 12 3
3 11 12 11 12 11 12 11 12 3  12 11 12 11 3  11 12 11 12 11 12 11 12 3
3 11 12 11 12 11 12 11 3  11 12 11 12 11 12 3  12 11 12 11 12 11 12 3
3 11 12 11 12 11 12 3  12 11 12 11 12 11 12 11 3  11 12 11 12 11 12 3
3 11 12 11 12 11 3  11 12 11 12 11 12 11 12 11 12 3 12 11 12 11 12 3
3 11 12 11 12 11 12 11 12 11 12 11 12 11 12 11 12 11 12 11 12 11 12 3
3 11 12 11 12 11 12 11 12 11 12 11 12 11 12 11 12 11 12 11 12 11 12 3
3 11 12 11 12 11 12 11 12 11 12 11 12 11 12 11 12 11 12 11 12 11 12 3
3 11 12 11 12 11 12 11 12 11 12 11 12 11 12 11 12 11 12 11 12 11 12 3
3 11 12 11 12 11 12 11 12 11 12 11 12 11 12 11 12 11 12 11 12 11 12 3
3 11 12 11 12 11 12 11 12 11 12 11 12 11 12 11 12 11 12 11 12 11 12 3
3 11 12 11 12 11 12 11 12 11 12 11 12 11 12 11 12 11 12 11 12 11 12 3
3 3 3 3 3 11 12 11 12 11 12 11 12 11 12 11 12 11 12 3 3 3 3 3
3 3 3 3 3 11 12 11 12 11 12 11 12 11 12 11 12 11 12 3 3 3 3 3
3 3 3 3 3 11 12 11 12 11 12 11 12 11 12 11 12 11 12 3 3 3 3 3
3 11 12 11 12 11 12 11 12 11 12 11 12 11 12 11 12 11 12 11 12 11 12 3
3 11 12 11 12 11 12 11 12 11 12 11 12 11 12 11 12 11 12 11 12 11 12 3
3 11 12 11 12 11 12 11 12 11 12 11 12 11 12 11 12 11 12 11 12 11 12 3
3 11 12 11 12 11 12 11 12 11 12 11 12 11 12 11 12 11 12 11 12 11 12 3
3 11 12 11 12 11 12 11 12 11 12 11 12 11 12 11 12 11 12 11 12 11 12 3
3 11 12 11 12 11 12 11 12 11 12 11 12 11 12 11 12 11 12 11 12 11 12 3
3 11 12 11 12 3  12 11 12 11 12 11 12 11 12 11 12 11 3  11 12 11 12 3
3 11 12 11 12 3  12 11 12 11 12 11 12 11 12 11 12 11 3  11 12 11 12 3
3 11 12 11 12 3  12 11 12 11 12 11 12 11 12 11 12 11 3  11 12 11 12 3
3 11 12 11 12 3  12 11 12 11 12 11 12 11 12 11 12 11 3  11 12 11 12 3
3 11 12 11 12 3  12 11 12 11 12 11 12 11 12 11 12 11 3  11 12 11 12 3
3 11 12 11 12 3  12 11 12 11 12 11 12 11 12 11 12 11 3  11 12 11 12 3
3 11 12 11 12 3  12 11 12 11 12 11 12 11 12 11 12 11 3  11 12 11 12 3
3 11 12 11 12 3  12 11 12 11 12 11 12 11 12 11 12 11 3  11 12 11 12 3
3 11 12 11 12 3  12 11 12 11 12 11 12 11 12 11 12 11 3  11 12 11 12 3
3 11 12 11 12 3  12 11 12 11 12 11 12 11 12 11 12 11 3  11 12 11 12 3
3 11 12 11 12 3  12 11 12 11 12 11 12 11 12 11 12 11 3  11 12 11 12 3
3 11 12 11 12 3  12 11 12 11 12 11 12 11 12 11 12 11 3  11 12 11 12 3
3 11 12 11 12 3  12 11 12 11 12 11 12 11 12 11 12 11 3  11 12 11 12 3
3 11 12 11 12 11 12 11 12 11 12 11 12 11 12 11 12 11 12 11 12 11 12 3
3 11 12 11 12 11 12 11 12 11 12 11 12 11 12 11 12 11 12 11 12 11 12 3
3 11 12 11 12 11 12 11 12 11 12 11 12 11 12 11 12 11 12 11 12 11 12 3
3 11 12 11 12 11 12 11 12 11 12 11 12 11 12 11 12 11 12 11 12 11 12 3
3 11 12 11 12 11 12 11 12 11 12 11 12 11 12 11 12 11 12 11 12 11 12 3
3 11 12 11 12 11 12 11 12 11 12 11 12 11 12 11 12 11 12 11 12 11 12 3
3 11 12 11 12 11 12 11 12 11 12 11 12 11 12 11 12 11 12 11 12 11 12 3
3 3 3 3 3 11 12 11 12 11 12 11 12 11 12 11 12 11 12 3 3 3 3 3
