OBJECTPOSITION
24 84   -- Size of Tilemap
2       -- Size of blocks in tilemap
-1 -1 -1 -1 -1 -1 -1 -1 -1 -1 -1 -1 -1 -1 -1 -1 -1 -1 -1 -1 -1 -1 -1 -1
-1  9  -2 9  -2 7 7 -2 -2 -2 -2 -2 -2 -2 -2 -2 -2 7 7  9  -2  9  -2 -1
-1  -2 -2 -2 -2 7 7 -2 -2 -2 -2 -2 -2 -2 -2 -2 -2 7 7  -2 -2  -2 -2 -1
-1  9  -2 9  -2 7 7 -2 -2 -2 -2 -2 -2 -2 -2 -2 -2 7 7  9  -2  9  -2 -1
-1  -2 -2 -2 -2 7 7 -2 -2 -2 -2 -2 -2 -2 -2 -2 -2 7 7  -2 -2  -2 -2 -1
-1  10 -2 8  -2 7 7 -2 -2 -2 -2 -2 -2 -2 -2 -2 -2 7 7  8  -2  10 -2 -1
-1  -2 -2 -2 -2 7 7 -2 -2 -2 -2 -2 -2 -2 -2 -2 -2 7 7  -2 -2  -2 -2 -1
-1  10 -2 8  -2 7 7 -2 -2 -2 -2 -2 -2 -2 -2 -2 -2 7 7  8  -2  10 -2 -1
-1  -2 -2 -2 -2 7 7 -2 -2 -2 -2 -2 -2 -2 -2 -2 -2 7 7  -2 -2  -2 -2 -1
-1  11 -2 11 -2 7 7 -2 -2 -2 -2 -2 -2 -2 -2 -2 -2 7 7  11 -2 11 -2 -1
-1  -2 -2 -2 -2 7 7 -2 -2 -2 -2 -2 -2 -2 -2 -2 -2 7 7  -2 -2 -2 -2 -1
-1  11 -2 11 -2 7 7 -2 -2 -2 -2 -2 -2 -2 -2 -2 -2 7 7  11 -2 11 -2 -1
-1  -2 -2 -2 -2 7 7 -2 -2 -2 -2 -2 -2 -2 -2 -2 -2 7 7  -2 -2 -2 -2 -1
-1 -1 -1 -1 -1  7 7 -2 -2 -2 -2 -2 -2 -2 -2 -2 -2 7 7 -1 -1 -1 -1 -1
-1 -1 -1 -1 -1  7 7 -2 -2 -2 -2 -2 -2 -2 -2 -2 -2 7 7 -1 -1 -1 -1 -1
-1  7  7  7  7  7 7  2  2  2  2  2  2  2  2  2  2 7 7  7  7  7  7 -1
-1 -2 -2 -2 -2 -2 -2 -2 -2 -2 -2 -2 -2 -2 -2 -2 -2 -2 -2 -2 -2 -2 -2 -1
-1 -2 -2 -2 -2 -2 -2 -2 -2 -2 -2 -2 -2 -2 -2 -2 -2 -2 -2 -2 -2 -2 -2 -1
-1 -2 -2 -2 -2 -2 -2 -2 -2 -2 -2 -2 -2 -2 -2 -2 -2 -2 -2 -2 -2 -2 -2 -1
-1 -2 -2 -2 -2 -2 -2 -2 -2 -2 -2 -2 -2 -2 -2 -2 -2 -2 -2 -2 -2 -2 -2 -1
-1 -2 -2 -2 -2 -2 -2 -2 -2 -2 -2 -2 -2 -2 -2 -2 -2 -2 -2 -2 -2 -2 -2 -1
-1 -2 -2 -2 -2 -2 -2 -2 -2 -2 -2 -2 -2 -2 -2 -2 -2 -2 -2 -2 -2 -2 -2 -1
-1 -2 -2 -2 -2 -2 -2 -2 -2 -2 -2 -2 -2 -2 -2 -2 -2 -2 -2 -2 -2 -2 -2 -1
-1 -2 -2 -2 -2 -2 -2 -2 -2 -2 -2 -2 -2 -2 -2 -2 -2 -2 -2 -2 -2 -2 -2 -1
-1 -2 -2 -2 -2 -2 -2 -2 -2 -2 -2 -2 -2 -2 -2 -2 -2 -2 -2 -2 -2 -2 -2 -1
-1 -2 -2 -2 -2 -2 -2 -2 -2 -2 -2 -2 -2 -2 -2 -2 -2 -2 -2 -2 -2 -2 -2 -1
-1 -2 -2 -2 -2 -2 -2 -2 -2 -2 -2 -2 -2 -2 -2 -2 -2 -2 -2 -2 -2 -2 -2 -1
-1 -1 -1 -1 -1 -1 -1 -1 -2 -2 -2 -2 -2 -2 -2 -2 -1 -1 -1 -1 -1 -1 -1 -1
-1 -1 -1 -1 -1 -1 -1 -1 -2 -2 -2 -2 -2 -2 -2 -2 -1 -1 -1 -1 -1 -1 -1 -1
-1 -2 -2 -2 -2 -2 -2 -2 -2 -2 -2 -2 -2 -2 -2 -2 -2 -2 -2 -2 -2 -2 -2 -1
-1 -2 -2 -2 -2 -2 -2 -2 -2 -2 -2 -2 -2 -2 -2 -2 -2 -2 -2 -2 -2 -2 -2 -1
-1 -2 -2 -2 -2 -2 -2 -2 -2 -2 -2 -2 -2 -2 -2 -2 -2 -2 -2 -2 -2 -2 -2 -1
-1 -2 -2 -2 -2 -2 -2 -2 -2 -2 -2 -2 -2 -2 -2 -2 -2 -2 -2 -2 -2 -2 -2 -1
-1 -2 -2 -2 -2 -2 -2 -2 -2 -2 -2 -2 -2 -2 -2 -2 -2 -2 -2 -2 -2 -2 -2 -1
-1 0 0 -2 -2 -2 -2 -2 -2  -2  -2  -2  -2  -2  -2 -2 -2 -2 -2 -2 -2 0 0 -1
-1 -2 -2 0 0 -2 -2 -2 -2  -2  -2  -2  -2  -2  -2 -2 -2 -2 -2 0 0 -2 -2 -1
-1 -2 -2 -2 -2 0 0 -2 -2  -2  -2  -2  -2  -2  -2 -2 -2 0 0 -2 -2 -2 -2 -1
-1 -2 -2 -2 -2 -2 -2 0 0  0  0  0  0  0  0 0 0 -2 -2 -2 -2 -2 -2 -1
-1 -2 -2 -2 -2 -2 -2 0 0  0  0  4  4  0  0 0 0 -2 -2 -2 -2 -2 -2 -1
-1 -2 -2 -2 -2 -2 -2 4 4  4  4  7  7  4  4 4 4 -2 -2 -2 -2 -2 -2 -1
-1 -2 -2 -2 -2 -2 -2 4 4  7  7  -13 -2  7  7 4 4 -2 -2 -2 -2 -2 -2 -1
-1 -2 -2 -2 -2 -2 -2 7 7  7  7  -2 -2 7  7 7 7 -2 -2 -2 -2 -2 -2 -1
-1 -2 -2 -2 -2 -2 -2 -2 -2 -1 -1 -1 -1 -1 -1 -2 -2 -2 -2 -2 -2 -2 -2 -1
-1 -2 -2 -2 -2 -2 -2 0 0  0  0  0  0  0  0 0 0 -2 -2 -2 -2 -2 -2 -1
-1 -2 -2 -2 -2 -2 -2 -2 -2 -2 -2 -2 -2 -2 -2 -2 -2 -2 -2 -2 -2 -2 -2 -1
-1 -2 -2 -2 -2 -2 -2 -2 -2 -2 -2 -2 -2 -2 -2 -2 -2 -2 -2 -2 -2 -2 -2 -1
-1 -2 -2 -2 -2 -2 -2 -2 -2 -2 -2 -2 -2 -2 -2 -2 -2 -2 -2 -2 -2 -2 -2 -1
-1 0 0 -2 -2 -2 -2 -2 -2 -2 -2 -2 -2 -2 -2 -2 -2 -2 -2 -2 -2 0 0 -1
-1 -2 -2 0 0 0 0 -2 -2 -2 -2 -2 -2 -2 -2 -2 -2 0 0 0 0 -2 -2 -1
-1 0 0 -2 -2 -2 -2 -2 -2 -2 -2 -2 -2 -2 -2 -2 -2 -2 -2 -2 -2 0 0 -1
-1 -2 -2 -2 -2 -2 -2 -2 -2 -2 -2 -2 -2 -2 -2 -2 -2 -2 -2 -2 -2 -2 -2 -1
-1 -2 -2 -2 -2 -2 -2 -2 -2 -2 -2 -2 -2 -2 -2 -2 -2 -2 -2 -2 -2 -2 -2 -1
-1 -2 -2 -2 -2 -2 -2 -2 -2 -2 -2 -2 -2 -2 -2 -2 -2 -2 -2 -2 -2 -2 -2 -1
-1 -2 -2 -2 -2 -2 -2 -2 -2 -2 -2 -2 -2 -2 -2 -2 -2 -2 -2 -2 -2 -2 -2 -1
-1 -2 -2 -2 -2 -2 -2 -2 -2 -2 -2 -2 -2 -2 -2 -2 -2 -2 -2 -2 -2 -2 -2 -1
-1 -1 -1 -1 -1 -1 -1 -1 -2 -2 -2 -2 -2 -2 -2 -2 -1 -1 -1 -1 -1 -1 -1 -1
-1 -1 -1 -1 -1 -1 -1 -1 -2 -2 -2 -2 -2 -2 -2 -2 -1 -1 -1 -1 -1 -1 -1 -1
-1 -2 -2 -2 -2 -2 -2 -2 -2 -2 -2 -2 -2 -2 -2 -2 -2 -2 -2 -2 -2 -2 -2 -1
-1 -2 -2 -2 -2 -2 -2 -2 -2 -2 -2 -2   -2 -2 -2 -2 -2 -2 -2 -2 -2 -2 -2 1
-1 -2 -2 -2 -2 -2 -2 -2 -2 -2 -2 -2   -2 -2 -2 -2 -2 -2 -2 -2 -2 -2 -2 -1
-1 -2 -2 -2 -2 -2 -2 -2 -2 7 7 -13 -2 7 7 -2 -2 -2 -2 -2 -2 -2 -2 -1
-1 -2 -2 -2 -2 -2 -2 7 7 5 5 -2   -2 5 5 7 7 -2 -2 -2 -2 -2 -2 -1
-1 -2 -2 -2 -2 7 7 4 4 4 4 4  4  4 4 4 4 7 7 -2 -2 -2 -2 -1
-1 -2 -2 -2 -2 -2 -2 0 0 0 0 0  0  0 0 0 0 -2 -2 -2 -2 -2 -2 -1
-1 -2 -2 -2 -2 -2 -2 -2 -2 0 0 0  0  0 0 -2 -2 -2 -2 -2 -2 -2 -2 -1
-1 -2 -2 -2 -2 -2 -2 -2 -2 -2 -2 0  0  -2 -2 -2 -2 -2 -2 -2 -2 -2 -2 -1
-1 -2 -2 -2 -2 -2 -2 -2 -2 -2 -2 -2 -2 -2 -2 -2 -2 -2 -2 -2 -2 -2 -2 -1
-1 -2 -2 -2 -2 -2 -2 -2 -2 -2 -2 -2 -2 -2 -2 -2 -2 -2 -2 -2 -2 -2 -2 -1
-1 -2 -2 -2 -2 -2 -2 -2 -2 -2 -2 -2 -2 -2 -2 -2 -2 -2 -2 -2 -2 -2 -2 -1
-1 -2 -2 -2 -2 -2 -2 -2 -2 -2 -2 -2 -2 -2 -2 -2 -2 -2 -2 -2 -2 -2 -2 -1
-1 0 0 0 0 -2 -2 -2 -2 -2 -2 -2 -2 -2 -2 -2 -2 -2 -2 0 0 0 0 -1
-1 0 0 0 0 -2 -2 -2 -2 -2 -2 -2 -2 -2 -2 -2 -2 -2 -2 0 0 0 0 -1
-1 0 0 0 0 -2 -2 -2 -2 -2 -2 -2 -2 -2 -2 -2 -2 -2 -2 0 0 0 0 -1
-1 -2 -2 -2 -2 -2 -2 -2 -2 -2 -2 -2 -2 -2 -2 -2 -2 -2 -2 -2 -2 -2 -2 -1
-1 -2 -2 -2 -2 -2 -2 -2 -2 -2 -2 -2 -2 -2 -2 -2 -2 -2 -2 -2 -2 -2 -2 -1
-1 -2 -2 -2 -2 -2 -2 -2 -2 -2 -2 -2 -2 -2 -2 -2 -2 -2 -2 -2 -2 -2 -2 -1
-1 -2 -2 -2 -2 -2 -2 -2 -2 -2 -2 -2 -2 -2 -2 -2 -2 -2 -2 -2 -2 -2 -2 -1
-1 -2 -2 -2 -2 -2 -2 -2 -2 -2 -2 -2 -2 -2 -2 -2 -2 -2 -2 -2 -2 -2 -2 -1
-1 -2 -2 -2 -2 -2 -2 -2 -2 -2 -2 -2 -2 -2 -2 -2 -2 -2 -2 -2 -2 -2 -2 -1
-1 -2 -2 -2 -2 -2 -2 -2 -2 -2 -2 -2 -2 -2 -2 -2 -2 -2 -2 -2 -2 -2 -2 -1
-1 -2 -2 -2 -2 -2 -2 -2 -2 -2 -2 -2 -2 -2 -2 -2 -2 -2 -2 -2 -2 -2 -2 -1
-1 -2 -2 -2 -2 -2 -2 -2 -2 -2 -2 -2 -2 -2 -2 -2 -2 -2 -2 -2 -2 -2 -2 -1
-1 -2 -2 -2 -2 -2 -2 -2 -2 -2 -2 -2 -2 -2 -2 -2 -2 -2 -2 -2 -2 -2 -2 -1
-1 -1 -1 -1 -1 -1 -1 -1 -2 -2 -2 -2 -2 -2 -2 -2 -1 -1 -1 -1 -1 -1 -1 -1