OBJECTPOSITION
24 84   -- Size of Tilemap
2       -- Size of blocks in tilemap
-3 -3 -3 -3 -3 -3 -3 -3 -3 -3 -3 -3 -3 -3 -3 -3 -3 -3 -3 -3 -3 -3 -3 -3
-3 8  -1  8  -1  7 7 -1 -1 -1 -1 -1 -1 -1 -1 -1 -1 7 7 8  -1  8  -1  -3
-3 -1  -1  -1  -1  7 7 -1 -1 -1 -1 -1 -1 -1 -1 -1 -1 7 7 -1  -1  -1  -1  -3
-3 10 -1  10 -1  7 7 -1 -1 -1 -1 12 -1 -1 -1 -1 -1 7 7 10 -1  10 -1  -3
-3 -1  -1  -1  -1  7 7 -1 -1 -1 -1 -1 -1 -1 -1 -1 -1 7 7 -1  -1  -1  -1  -3
-3 9  -1  9  -1  7 7 -1 -1 -1 -1 -1 -1 -1 -1 -1 -1 7 7 9  -1  9  -1  -3
-3 -1  -1  -1  -1  7 7 -1 -1 -1 -1 -1 -1 -1 -1 -1 -1 7 7 -1  -1  -1  -1  -3
-3 -3 -3 -3 -3 7 7 -1 -1 -1 -1 -1 -1 -1 -1 -1 -1 7 7 -3 -3 -3 -3 -3
-3 -1 -1 -1 -1 -1 -1 -1  -1 -1 -1 -1 -1 -1 -1 -1 -1 -1 -1 -1 -1 -1 -1 -3
-3 -1 -1 -1 -1 -1 -1 -1  -1  -3 -3 -3 -3 -3 -3 -1 -1 -1 -1 -1 -1 -1 -1 -3
-3 -1 -1 -1 -1 -1 -1 -1  -1  -3  11 -1 11  -1 -3 -1 -1 -1 -1 -1 -1 -1 -1 -3
-3 -1 -1 -1 -1 -1 -1 -3 -3 -3  -1  -1  -1  -1 -3 -3 -3 -1 -1 -1 -1 -1 -1 -3
-3 -1 -1 -1 -1 -1 -1 -3 2  2   5  5  5  5  2 2  -3 -1 -1 -1 -1 -1 -1 -3
-3 -1 -1 -1 -1 -1 -1 -3 3  3   2  2  2  2  3 3  -3 -1 -1 -1 -1 -1 -1 -3
-3 -1 -1 -1 -1 -1 -1 6  6  6   6  6  6  6  6 6  6  -1 -1 -1 -1 -1 -1 -3
-3 -1 -1 -1 -1 -1 -1 -1 -1 -1 -1 -1 -1 -1 -1 -1 -1 -1 -1 -1 -1 -1 -1 -3
-3 -1 -1 -1 -1 -1 -1 -1 -1 -1 -1 -1 -1 -1 -1 -1 -1 -1 -1 -1 -1 -1 -1 -3
-3 -1 -1 -1 -1 -1 -1 -1 -1 -1 -1 -1 -1 -1 -1 -1 -1 -1 -1 -1 -1 -1 -1 -3
-3 -1 -1 -1 -1 -1 -1 -1 -1 -1 -1 -1 -1 -1 -1 -1 -1 -1 -1 -1 -1 -1 -1 -3
-3 -3 -3 -3 -3 -1 -1 -1 -1 -1 -1 -1 -1 -1 -1 -1 -1 -1 -1 -3 -3 -3 -3 -3
-3 -1 -1 -1 -1 -3 -3 -3 -3 -1 -1 -1 -1 -1 -1 -3 -3 -3 -3 -1 -1 -1 -1 -3
-3 2 2 2 2 2 2 2 2 2 2 2 2 2 2 2 2 2 2 2 2 2 2 -3
-3 -1 -1 -1 -1 -1 -1 -1 -1 -1 -1 -1 -1 -1 -1 -1 -1 -1 -1 -1 -1 -1 -1 -3
-3 -1 -1 -1 -1 -1 -1 -1 -1 -1 -1 -1 -1 -1 -1 -1 -1 -1 -1 -1 -1 -1 -1 -3
-3 -1 -1 -1 -1 -1 -1 -1 -1 -1 -1 -1 -1 -1 -1 -1 -1 -1 -1 -1 -1 -1 -1 -3
-3 -1 -1 -1 -1 -1 -1 -1 -1 -1 -1 -1 -1 -1 -1 -1 -1 -1 -1 -1 -1 -1 -1 -3
-3 -1 -1 -1 -1 -1 -1 -1 -1 -1 -1 -1 -1 -1 -1 -1 -1 -1 -1 -1 -1 -1 -1 -3
-3 -3 -3 -3 -3 -1 -1 -1 -1 -1 -1 -1 -1 -1 -1 -1 -1 -1 -1 -3 -3 -3 -3 -3
-3 -3 -3 -3 -3 -1 -1 -1 -1 -1 -1 -1 -1 -1 -1 -1 -1 -1 -1 -3 -3 -3 -3 -3
-3 -1 -1 -1 -1 -1 -1 -1 -1 -1 -1 -1 -1 -1 -1 -1 -1 -1 -1 -1 -1 -1 -1 -3
-3 2 2 2 2 2 2 2 2 2 2 2 2 2 2 2 2 2 2 2 2 2 2 -3
-3 -1 -1 -1 -1 -1 -1 -1 -1 -1 -1 -1 -1 -1 -1 -1 -1 -1 -1 -1 -1 -1 -1 -3
-3 -1 -1 -1 -1 -1 -1 -1 -1 -1 -1 -1 -1 -1 -1 -1 -1 -1 -1 -1 -1 -1 -1 -3
-3 -1 -1 -1 -1 -1 -1 -1 -1 -1 -1 -1 -1 -1 -1 -1 -1 -1 -1 -1 -1 -1 -1 -3
-3 -1 -1 -1 -1 -1 -1 -1 -1 -1 -1 -1 -1 -1 -1 -1 -1 -1 -1 -1 -1 -1 -1 -3
-3 -1 -1 -1 -1 -1 -1 -1 -1 -1 -1 -1 -1 -1 -1 -1 -1 -1 -1 -1 -1 -1 -1 -3
-3 -1 -1 -1 -1 -1 -3 7 7 7 7 7 7 7 7 7 7 -3 -1 -1 -1 -1 -1 -3
-3 -1 -1 -1 -1 7 7 -3 2 2 1 1 1 1 2 2 -3 7 7 -1 -1 -1 -1 -3
-3 -1 -1 -1 -1 7 7 -1 -3 2 2 3 3 2 2 -3 -1 7 7 -1 -1 -1 -1 -3
-3 -1 -1 -1 -1 7 7 2 2 -3 -1 13 -1 -1 -3 2 2 7 7 -1 -1 -1 -1 -3
-3 -1 -1 -1 -1 7 7 3 3 -1 -3 -1 -1 -3 -1 3 3 7 7 -1 -1 -1 -1 -3
-3 -1 -1 -1 -1 7 7 3 3 1 1 -3 -3 1 1 3 3 7 7 -1 -1 -1 -1 -3
-3 -1 -1 -1 -1 7 7 3 3 1 1 -3 -3 1 1 3 3 7 7 -1 -1 -1 -1 -3
-3 -1 -1 -1 -1 7 7 3 3 -1 -3 -1 -1-3 -1 3 3 7 7 -1 -1 -1 -1 -3
-3 -1 -1 -1 -1 7 7 2 2 -3 -1 -1 -1 -1 -3 2 2 7 7 -1 -1 -1 -1 -3
-3 -1 -1 -1 -1 7 7 -1 -3 -1 -1 -1 -1 -1 -1 -3 -1 7 7 -1 -1 -1 -1 -3
-3 -1 -1 -1 -1 7 7 -3 2 2 -1 -1 -1 -1 2 2 -3 7 7 -1 -1 -1 -1 -3
-3 -1 -1 -1 -1 -1 -3 7 7 7 7 7 7 7 7 7 7 -3 -1 -1 -1 -1 -1 -3
-3 -1 -1 -1 -1 -1 -1 -1 -1 -1 -1 -1 -1 -1 -1 -1 -1 -1 -1 -1 -1 -1 -1 -3
-3 -1 -1 -1 -1 -1 -1 -1 -1 -1 -1 -1 -1 -1 -1 -1 -1 -1 -1 -1 -1 -1 -1 -3
-3 -1 -1 -1 -1 -1 -1 -1 -1 -1 -1 -1 -1 -1 -1 -1 -1 -1 -1 -1 -1 -1 -1 -3
-3 -1 -1 -1 -1 -1 -1 -1 -1 -1 -1 -1 -1 -1 -1 -1 -1 -1 -1 -1 -1 -1 -1 -3
-3 -1 -1 -1 -1 -1 -1 -1 -1 -1 -1 -1 -1 -1 -1 -1 -1 -1 -1 -1 -1 -1 -1 -3
-3 -1 -1 -1 -1 -1 -1 -1 -1 -1 -1 -1 -1 -1 -1 -1 -1 -1 -1 -1 -1 -1 -1 -3
-3 -3 -3 -3 -3 -1 -1 -1 -1 -1 -1 -1 -1 -1 -1 -1 -1 -1 -1 -3 -3 -3 -3 -3
-3 -3 -3 -3 -3 -1 -1 -1 -1 -1 -1 -1 -1 -1 -1 -1 -1 -1 -1 -3 -3 -3 -3 -3
-3 -3 -3 -3 -3 -1 -1 -1 -1 -1 -1 -1 -1 -1 -1 -1 -1 -1 -1 -3 -3 -3 -3 -3
-3 -1 -1 -1 -1 -1  -1 -1 -1 -1 -1 -1 -1 -1 -1 -1 -1 -1 -1  -1 -1 -1 -1 -3
-3 -1 -1 -1 -1 -1  -1 -1 -1 -1 -1 -1 -1 -1 -1 -1 -1 -1 -1  -1 -1 -1 -1 -3
-3 -1 -1 -1 -1 -1  -1 -1 -1 -1 -1 -1 -1 -1 -1 -1 -1 -1 -1  -1 -1 -1 -1 -3
-3 -1 -1 -1 -1 -1  -1 -1 -1 -1 -1 -1 -1 -1 -1 -1 -1 -1 -1  -1 -1 -1 -1 -3
-3 -1 -1 -1 -1 -1  -1 -1 -1 -1 -1 -1 -1 -1 -1 -1 -1 -1 -1  -1 -1 -1 -1 -3
-3 2 2 2 2 -1  -1 -1 -1 -1 -1 -1 -1 -1 -1 -1 -1 -1 -1  2 2 2 2 -3
-3 2 2 -1 -1 -3 2 2 2 2 -1 -1 -1 -1 2 2 2 2 -3 -1 -1 -1 -1 -3
-3 -1 -1 2 2 -3 -1 -1 -1 -1 -1 -1 -1 -1 -1 -1 -1 -1 -3 -1 -1 -1 -1 -3
-3 2 2 -1 -1 -3 -1 -1 -1 -1 -1 -1 -1 -1 -1 -1 -1 -1 -3 -1 -1 -1 -1 -3
-3 -1 -1 2 2 -3 -1 -1 -1 -1 -1 -1 -1 -1 -1 -1 -1 -1 -3 13 -1 -1 -1 -3
-3 2 2 -1 -1 -3 -1 -1 -1 -1 -1 -1 -1 -1 -1 -1 -1 -1 -3 -1 -1 -1 -1 -3
-3 -1 -1 2 2 -3 -1 -1 -1 -1 -1 -1 -1 -1 -1 -1 -1 -1 -3 3 3 3 3 -3
-3 2 2 -1 -1 -3 1 1 1 1 3 3 3 3 1 1 1 1 -3 4 4 4 4 -3
-3 -1 -1 2 2 -3 5 5 3 3 1 1 1 1 3 3 5 5 -3 3 3 3 3 -3
-3 2 2 -1 -1 -3 3 3 5 5 2 2 2 2 5 5 3 3 -3 4 4 4 4 -3
-3 -1 -1 2 2 -3 3 3 2 2 5 5 5 5 2 2 3 3 -3 3 3 3 3 -3
-3 2 2 -1 -1 -3 2 2 3 3 5 5 5 5 3 3 2 2 -3 4 4 4 4 -3
-3 -1 -1 2 2 -3 2 2 5 5 3 3 3 3 5 5 2 2 -3 3 3 3 3 -3
-3 -1 -1 -1 -1 -3 5 5 2 2 3 3 3 3 2 2 5 5 -3 4 4 4 4 -3
-3 -1 -1 -1 -1 -1  -1 -1 -1 -1 -1 -1 -1 -1 -1 -1 -1 -1 -1  -1 -1 -1 -1 -3
-3 -1 -1 -1 -1 -1  -1 -1 -1 -1 -1 -1 -1 -1 -1 -1 -1 -1 -1  -1 -1 -1 -1 -3
-3 -1 -1 -1 -1 -1  -1 -1 -1 -1 -1 -1 -1 -1 -1 -1 -1 -1 -1  -1 -1 -1 -1 -3
-3 -1 -1 -1 -1 -1  -1 -1 -1 -1 -1 -1 -1 -1 -1 -1 -1 -1 -1  -1 -1 -1 -1 -3
-3 -1 -1 -1 -1 -1  -1 -1 -1 -1 -1 -1 -1 -1 -1 -1 -1 -1 -1  -1 -1 -1 -1 -3
-3 -1 -1 -1 -1 -1  -1 -1 -1 -1 -1 -1 -1 -1 -1 -1 -1 -1 -1  -1 -1 -1 -1 -3
-3 -1 -1 -1 -1 -1  -1 -1 -1 -1 -1 -1 -1 -1 -1 -1 -1 -1 -1  -1 -1 -1 -1 -3
-3 -3 -3 -3 -3 -1 -1 -1 -1 -1 -1 -1 -1 -1 -1 -1 -1 -1 -1 -3 -3 -3 -3 -3
