OBJECTPOSITION
24 86   -- Size of Tilemap
2       -- Size of blocks in tilemap
-2 -2 -2 -2 -2 -2 -2 -2 -2 -2 -2 -2 -2 -2 -2 -2 -2 -2 -2 -2 -2 -2 -2 -2
-2 -1 -1 -1 -1 -1 6  6  8  -1  8  -1  8  -1  8  -1  6  6  -1 -1 -1 -1 -1 -2
-2 -1 -1 -1 -1 -1 6  6  -1  -1  -1  -1  -1  -1  -1  -1  6  6  -1 -1 -1 -1 -1 -2
-2 -1 -1 -1 -1 -1 6  6  -1  -1  -1  -1  -1  -1  -1  -1  6  6  -1 -1 -1 -1 -1 -2
-2 -1 -1 -1 -1 -1 6  6  -1  -1  6  6  6  6  -1  -1  6  6  -1 -1 -1 -1 -1 -2
-2 -1 -1 -1 -1 -1 6  6  -1  -1  -1  -1  -1  -1  -1  -1  6  6  -1 -1 -1 -1 -1 -2
-2 -1 -1 -1 -1 -1 6  6  -1  -1  -1  -1  -1  -1  -1  -1  6  6  -1 -1 -1 -1 -1 -2
-2 -1 -1 -1 -1 -1 6  6  8  -1  8  -1  8  -1  8  -1  6  6  -1 -1 -1 -1 -1 -2
-2 -1 -1 -1 -1 -1 6  6  -1  -1  -1  -1  -1  -1  -1  -1  6  6  -1 -1 -1 -1 -1 -2
-2 -1 -1 -1 -1 -1 -2 -2 -2 -2 -2 -2 -2 -2 -2 -2 -2 -2 -1 -1 -1 -1 -1 -2
-2 -1 -1 -1 -1 -1 -2 11 -1 11 -1 11 -1 11 -1 11 -1 -2 -1 -1 -1 -1 -1 -2
-2 -1 -1 -1 -1 -1 -2 -1  -1 -1  -1 -1  -1 -1  -1  -1 -1 -2 -1 -1 -1 -1 -1 -2
-2 -1 -1 -1 -1 -1 -2 10 -1 10 -1 10 -1 10 -1 10 -1 -2 -1 -1 -1 -1 -1 -2
-2 -1 -1 -1 -1 -1 -2 -1  -1 -1  -1 -1  -1 -1  -1  -1 -1 -2 -1 -1 -1 -1 -1 -2
-2 -1 -1 -1 -1 -1 -2 9  -1 9  -1 9  -1 9  -1  9 -1 -2 -1 -1 -1 -1 -1 -2
-2 -1 -1 -1 -1 -1 -2 -1  -1 -1  -1 -1  -1 -1  -1  -1 -1 -2 -1 -1 -1 -1 -1 -2
-2 -1 -1 -1 -1 -1 -2 2  2 2  2 12 -1 2  2  2 2 -2 -1 -1 -1 -1 -1 -2
-2 -1 -1 -1 -1 -1 -2 2  2 2  2 -1  -1 2  2  2 2 -2 -1 -1 -1 -1 -1 -2
-2 -1 -1 -1 -1 -1 -1 -1 -1 -1 -1 -1 -1 -1 -1 -1 -1 -1 -1 -1 -1 -1 -1 -2
-2 -1 -1 -1 -1 -1 -1 -1 -1 -1 -1 -1 -1 -1 -1 -1 -1 -1 -1 -1 -1 -1 -1 -2
-2 -1 -1 -1 -1 -1 -1 6 6 -2 -2 -2 -2 -2 -2 6 6 -1 -1 -1 -1 -1 -1 -2
-2 -1 -1 -1 -1 -1 -1 -1 -1 -1 -1 -1 -1 -1 -1 -1 -1 -1 -1 -1 -1 -1 -1 -2
-2 -1 -1 -1 -1 -1 -1 -1 -1 -1 -1 -1 -1 -1 -1 -1 -1 -1 -1 -1 -1 -1 -1 -2
-2 -1 -1 -1 -1 -1 -1 -1 -1 -1 -1 -1 -1 -1 -1 -1 -1 -1 -1 -1 -1 -1 -1 -2
-2 -1 -1 -1 -1 -1 -1 -1 -1 -1 -1 -1 -1 -1 -1 -1 -1 -1 -1 -1 -1 -1 -1 -2
-2 -1 -1 -1 -1 -1 -1 -1 -1 -1 -1 -1 -1 -1 -1 -1 -1 -1 -1 -1 -1 -1 -1 -2
-2 -1 -1 -1 -1 -1 -1 -1 -1 -1 -1 -1 -1 -1 -1 -1 -1 -1 -1 -1 -1 -1 -1 -2
-2 -2 -2 -2 -2 -2 -1 -1 -1 -1 -1 -1 -1 -1 -1 -1 -1 -1 -2 -2 -2 -2 -2 -2
-2 -2 -2 -2 -2 -2 -1 -1 -1 -1 -1 -1 -1 -1 -1 -1 -1 -1 -2 -2 -2 -2 -2 -2
-2 -2 -2 -2 -2 -2 -1 -1 -1 -1 -1 -1 -1 -1 -1 -1 -1 -1 -2 -2 -2 -2 -2 -2
-2 -1 -1 -1 -1 -1 -1 -1 -1 -1 -1 -1 -1 -1 -1 -1 -1 -1 -1 -1 -1 -1 -1 -2
-2 -1 -1 -1 -1 -1 -1 -1 -1 -1 -1 -1 -1 -1 -1 -1 -1 -1 -1 -1 -1 -1 -1 -2
-2 -1 -1 -1 -1 -1 -1 -1 -1 -1 -1 -1 -1 -1 -1 -1 -1 -1 -1 -1 -1 -1 -1 -2
-2 -1 -1 -1 -1 -1 -1 -1 -1 -1 -1 -1 -1 -1 -1 -1 -1 -1 -1 -1 -1 -1 -1 -2
-2 -2 -2 -2 -2 -1 -1 2 2 -1 -1 -1 -1 -1 -1 2 2 -1 -1 -2 -2 -2 -2 -2
-2 13 -1  -1  -2 -1 -1 -1 -1 -1 -1 -1 -1 -1 -1 -1 -1 -1 -1 -2 -1 -1 -1 -2
-2 -1  -1  -1  -2 -1 -1 -1 -1 -1 -1 -1 -1 -1 -1 -1 -1 -1 -1 -2 -1 -1 -1 -2
-2 2  2  -1  -2 -1 -1 -1 -1 -1 -1 -1 -1 -1 -1 -1 -1 -1 -1 -2 -1 -1 -1 -2
-2 -1  -1  -1  -1  -1 -1 -1 -1 -1 -1 -1 -1 -1 -1 -1 -1 -1 -1  -1 -1 -1 -1 -2
-2 -1  -1  -1  -1  -1 -1 -1 -1 -1 -1 -1 -1 -1 -1 -1 -1 -1 -1  -1 -1 -1 -1 -2
-2 -1  -1  -1  -1  3 3 3 3 -1 -1 -1 -1 -1 -1 3 3 3 3  -1 -1 -1 -1 -2
-2 -1  -1  -1  -2 -1 -1 -1 -1 3 3 3 3 3 3 -1 -1 -1 -1 -2 -1 -1 -1 -2
-2 -1  -1  -1  -2 -1 -1 -1 -1 -1 -1 1 1 -1 -1 -1 -1 -1 -1 -2 -1 -1 -1 -2
-2 -1  -1  -1  -2 -1 -1 -1 -1 -1 -1 1 1 -1 -1 -1 -1 -1 -1 -2 -1 -1 -1 -2
-2 -2 -2 -2 -2 5 5 5 5 5 5 5 5 5 5 5 5 5 5 -2 -2 -2 -2 -2
-2 -1 -1 -1 -1 -1 -1 2 2 1 1 1 1 1 1 1 1 1 1 2 2 -1 -1 -2
-2 -1 -1 -1 -1 -1 -1 -1 -1 1 1 1 1 2 2 1 1 1 1 -1 -1 -1 -1 -2
-2 -1 -1 -1 -1 -1 -1 -1 -1 2 2 1 1 1 1 1 1 2 2 -1 -1 -1 -1 -2
-2 -1 -1 -1 -1 -1 -1 -1 -1 1 1 1 1 1 1 1 1 1 1 -1 -1 -1 -1 -2
-2 -1 -1 2 2 -1 -1 -1 -1 -2 -2 -2 -2 -2 -2 -1 -1 -1 -1 2 2 -1 -1 -2
-2 -1 -1 -1 -1 -1 -1 -1 -1 -1 -1 -1 -1 -1 -1 -1 -1 -1 -1 -1 -1 -1 -1 -2
-2 -1 -1 -1 -1 -1 -1 -1 -1 -1 -1 -1 -1 -1 -1 -1 -1 -1 -1 -1 -1 -1 -1 -2
-2 -1 -1 -1 -1 -1 -1 -1 -1 -1 -1 -1 -1 -1 -1 -1 -1 -1 -1 -1 -1 -1 -1 -2
-2 -1 -1 -1 -1 -1 -1 -1 -1 -1 -1 -1 -1 -1 -1 -1 -1 -1 -1 -1 -1 -1 -1 -2
-2 -1 -1 -1 -1 -1 -1 -1 -1 -1 -1 -1 -1 -1 -1 -1 -1 -1 -1 -1 -1 -1 -1 -2
-2 -1 -1 -1 -1 -1 -1 -1 -1 -1 -1 -1 -1 -1 -1 -1 -1 -1 -1 -1 -1 -1 -1 -2
-2 -2 -2 -2 -2 -2 -1 -1 -1 -1 -1 -1 -1 -1 -1 -1 -1 -1 -2 -2 -2 -2 -2 -2
-2 -2 -2 -2 -2 -2 -1 -1 -1 -1 -1 -1 -1 -1 -1 -1 -1 -1 -2 -2 -2 -2 -2 -2
-2 -2 -2 -2 -2 -2 -1 -1 -1 -1 -1 -1 -1 -1 -1 -1 -1 -1 -2 -2 -2 -2 -2 -2
-2 -1  -1  -1 -1 -1 -1 -1 -1 -1 -1 -1 -1 -1 -1 -1 -1 -1 -1 -1 -1 -1 -1 -2
-2 -1  -1  -1 -1 -1 -1 -1 -1 -1 -1 -1 -1 -1 -1 -1 -1 -1 -1 -1 -1 -1 -1 -2
-2 -1  -1  -1 -1 -1 -1 -1 -1 -1 -1 -1 -1 -1 -1 -1 -1 -1 -1 -1 -1 -1 -1 -2
-2 -1  -1  -1 -1 -1 -1 -1 -1 -1 -1 -1 -1 -1 -1 -1 -1 -1 -1 -1 -1 -1 -1 -2
-2 -1  -1  -1 -1 -1 -1 -1 -1 -1 -1 -1 -1 -1 -1 -1 -1 -1 -1 -1 -1 -1 -1 -2
-2 -1  -1  -1 -1 -1 -1 -1 -1 -1 -1 -1 -1 -1 -1 -1 -1 -1 -1 -1 -1 -1 -1 -2
-2 -1  -1  -1 -1 -1 -1 -1 -1 -1 -1 -1 -1 -1 -1 -1 -1 -1 -1 -1 -1 -1 -1 -2
-2 -1  -1  2 2 -1 -1 -1 -1 -1 -1 -1 -1 -1 -1 -1 -1 -1 -1 2 2 -1 -1 -2
-2 -1  -1  -1 -1 4 4 4 4 4 4 4 4 4 4 4 4 4 4 -1 -1 -1 -1 -2
-2 -2 -2 -1 -1 4 4 3 3 5 5 5 5 5 5 3 3 4 4 -1 -1 -2 -2 -2
-2 -2 -2 -1 -1 4 4 3 3 5 5 -1 -1 5 5 3 3 4 4 -1 -1 -2 -2 -2
-2 -2 -2 -1 -1 4 4 3 3 5 5 2 2 5 5 3 3 4 4 -1 -1 -2 -2 -2
-2 -2 -2 -1 -1 4 4 3 3 5 5 13 -1 5 5 3 3 4 4 -1 -1 -2 -2 -2
-2 -2 -2 -1 -1 4 4 3 3 5 5 -1 -1 5 5 3 3 4 4 -1 -1 -2 -2 -2
-2 -2 -2 -1 -1 4 4 3 3 5 5 2 2 5 5 3 3 4 4 -1 -1 -2 -2 -2
-2 -2 -2 -1 -1 4 4 3 3 5 5 -1 -1 5 5 3 3 4 4 -1 -1 -2 -2 -2
-2 -2 -2 -1 -1 4 4 3 3 5 5 5 5 5 5 3 3 4 4 -1 -1 -2 -2 -2
-2 -1  -1  -1 -1 4 4 4 4 4 4 4 4 4 4 4 4 4 4 -1 -1 -1 -1 -2
-2 -1  -1  2 2 -1 -1 -1 -1 -1 -1 -1 -1 -1 -1 -1 -1 -1 -1 2 2 -1 -1 -2
-2 -1  -1  -1 -1 -1 -1 -1 -1 -1 -1 -1 -1 -1 -1 -1 -1 -1 -1 -1 -1 -1 -1 -2
-2 -1  -1  -1 -1 -1 -1 -1 -1 -1 -1 -1 -1 -1 -1 -1 -1 -1 -1 -1 -1 -1 -1 -2
-2 -1  -1  -1 -1 -1 -1 -1 -1 -1 -1 -1 -1 -1 -1 -1 -1 -1 -1 -1 -1 -1 -1 -2
-2 -1  -1  -1 -1 -1 -1 -1 -1 -1 -1 -1 -1 -1 -1 -1 -1 -1 -1 -1 -1 -1 -1 -2
-2 -1  -1  -1 -1 -1 -1 -1 -1 -1 -1 -1 -1 -1 -1 -1 -1 -1 -1 -1 -1 -1 -1 -2
-2 -1  -1  -1 -1 -1 -1 -1 -1 -1 -1 -1 -1 -1 -1 -1 -1 -1 -1 -1 -1 -1 -1 -2
-2 -1  -1  -1 -1 -1 -1 -1 -1 -1 -1 -1 -1 -1 -1 -1 -1 -1 -1 -1 -1 -1 -1 -2
-2 -2 -2 -2 -2 -2 -1 -1 -1 -1 -1 -1 -1 -1 -1 -1 -1 -1 -2 -2 -2 -2 -2 -2
